NO textures/ik2.xpm
SO textures/ik2.xpm
WE textures/ik2.xpm
EA textures/ik2.xpm
F 0,255,255
C 0,0,255
111111111111111
10000000000000111111
10000000000000100000
100000000N0000111111
100000000000001
100000000000001
100000000000001
100000000000001
100000000000001
111111111111111
