NO textures/north
SO textures/south
WE textures/west
EA textures/east

F 0,255,255
C 0,0,255

111111111111111
100000000000001
100000000000001
10000Z000000001
100000000000001
100000000000001
100000000000001
100000000000001
100000000000001
111111111111111