NO 		textures/ik2.xpm
SO textures/ik2.xpm
				WE textures/ik2.xpm


	EA textures/ik2.xpm	


	 	F  0,	 255,255		

	C 		00, 23,   255


111111111111111
100000000000001
100000000000001
10000000000 N01
100000000000001
100000000000001
1   00000000001
100000000000001
111111110111111  		
       101
        1

