NO 		textures/ik2.xpm
SO textures/ik2.xpm
WE textures/ik2.xpm


	EA textures/ik2.xpm	


	 	F  0,	 255,255		

	C 		0, 23,    255


111111111111111
100000000000001
100000000000001
100000000000N01
100000000000001
100000000000001
100000000000001
100000000000001
111111111111111  		



