F 0,255,255
NO textures/ik2.xpm
EA textures/ik2.xpm
SO textures/ik2.xpm
WE textures/ik2.xpm
C 0,0,255
11111
1000111111111111111
10101
10001
10N11
10001
11111
