NO textures/ik2.xpm
EA textures/ik2.xpm
SO textures/ik2.xpm
WE textures/ik2.xpm
F 0,255,255
C 0,0,255
1111
1 N1
1 01
1111