NO textures/bonus_wallN.xpm
SO textures/bonus_wallS.xpm
WE textures/bonus_wallW.xpm
EA textures/bonus_wallE.xpm	
F 0,255,255
C 0,0,255
111111GHI111111
100000000000001
100000000000001
100000000000001
100000000000001
100000000000001
1000000N0000001
100000000000001
100000000000001
100000000000001
100000000000001
100000000000001
100000000000001
100000000000001
100000000000001
100000000000001
100000000000001
111111IHG111111