NO textures/kiri1.xpm
SO textures/kiri2.xpm
WE textures/kiri3.xpm
EA textures/kiri4.xpm	
F 0,255,75
C 25,25,181
11111111111111111111111111111111111111111111111111
11111111000000011000111111111100000110000111111111
11111000000000000000000111000000000000000001111111
11110000000000000000000000000000000000000000011111
11100000000000000000000000000000000000000010001111
11000000000000000000000000000000000000000000000111
11000000000010000000000000000000000000000000000111
11000000000000100000000000000000000000000000000111
11110000000000000000100N00000000000000000000000111
11100000000000000000000000100000000000000000001111
11110000000000000000000000000000000000000000011111
11111000000000000000000000000000000000000001111111
11111111000000000000000000000000000000000011111111
11111111111000000000000000000000000000011111111111
11111111111000000000000000000000000001111111111111
11111111111111000000000000000000000111111111111111
11111111111111110000000000000000010111111111111111
11111111111111111100000000000001111111111111111111
11111111111111111111100000001011111111111111111111
11111111111111111111111100111111111111111111111111
11111111111111111111111111111111111111111111111111