F 255,255,0
NO textures/ik1.xpm
EA textures/ik2.xpm
SO textures/ik3.xpm
WE textures/ik4.xpm
C 0,0,255
111111111111111
100000000000001
100000000000001
100000000000001
100000000N00001
100000000000001
100000000000001
100000000000001
111111111111111
