NO textures/ik1.xpm
SO textures/ik2.xpm
WE textures/ik3.xpm
EA textures/ik4.xpm
F 0,255,255
C 0,0,255
    1111111111111111111111111111111111
    1000000000000000000000000000000001
    1000000000000000000000000000000001
11111000000000011111111111111111111111
100000000000001
10000000000000N1
100000000000001
100111000000001
1001 1000000001
1111 1111111111
