NO textures/bonus_wallN.xpm
SO textures/bonus_wallS.xpm
EA textures/bonus_wallE.xpm
WE textures/bonus_wallW.xpm

F 40,206,69
C 170,223,253

111111GHI111111
100000000000001
100000000000001
10000B000000001
1000000N0000001
100000000000001
100000000000001
100000000000001
100000000000001
100000000000001
100000000000001
100000000000001
111111111111111
