NO textures/north
SO textures/south
WE textures/west
EA textures/east

F 0,255,255
C 0,0,255

111111111111111
100000000000001
100000000000001
100000000000001
100000000000001
100000000000001
100000000000001
100111000000001
1001 1000000001
1111 1111111111