F 0,    255,255
NO textures/ik2.xpm
EA textures/ik2.xpm
SO textures/ik2.xpm
WE textures/ik2.xpm    
        C   0,0,            255   
111111111111111
100000000000001
100000000000001
100000000000001
100000000000001
10000000000N001
100000000000001
100000000000001
111111111111111
