F 0,    255,255
NO textures/north
                EA textures/east
SO                      textures/south
WE  textures/west    

        C   0,0,            255

100000000000001
100000000000001
100000000000001
100000000000001
100000000000001
100000000000001
100000000000001
100000000000001
111111111111111