NO textures/ik1.xpm
SO textures/ik2.xpm
WE textures/ik3.xpm
EA textures/ik4.xpm	
F 0,255,255
C 0,0,255
                                        1111111111111111                                        
                                   1111111111111111111111111                                    
                              1111111111111111111111111111111111                                
                           11111111111111111111111111111111111111111                            
                        1111111111111111111111111111111111111111111111                          
                      11111111111111111111111111111111111111111111111111                        
                    1111111111111111111111111111111111111111111111111111111                     
                  111111111111111111111111111111111111111111111111111111111111                  
                111111111111111111000000000000000000000000011111111111111111111                 
              1111111111111110000000000000000000000000000000000111111111111111111               
             111111111111100000000000000000000000000000000000000001111111111111111              
            11111111111100000000000000000000000000000000000000000000111111111111111             
           1111111111100000000000000000000000000000000000000000000000011111111111111            
          111111111110000000000000000000000000000000000000000000000000001111111111111           
         11111111111000000000000000000000000000000000000000000000000000000111111111111          
        1111111111000000000000000000000000000000000000000000000000000000000111111111111         
       111111111100000000000000000000000000000000000000000000000000000000000011111111111        
       11111111100000000000000000000000000000000000000000000000000000000000000011111111111      
      1111111110000000000000000000000000000000000000000000000000000000000000000011111111111     
     111111111000000000000000000000000000000000000000000000000000000000000000000011111111111    
     11111111000000000000000000000000000000000000000000000000000000000000000000000111111111     
    1111111100000000000000000000000000000000000000000000000000000000000000000000000111111111    
    111111110000000000000000000000000000000000000000000000000000000000000000000000001111111     
   11111111000000000000000000000000000000000000000000000000000000000000000000000000001111111    
   1111111000000000000000000000000000000000000000000000000000000000000000000000000000111111     
   111111100000000000000000000000000000000000000000000000000000000000000000000000000011111      
  11111110000000000000000000000000000000000000000000000000000000000000000000000000000111111    
  1111111000000000000000000000000000000000000000000000000000000000000000000000000000001111     
  111111000000000000000000000000000000000000000000000000000000000000000000000000000000111      
  11111100000000000000000000000000000000000000000000000000000000000000000000000000000111       
  1111110000000000000000000000000000000000000000000000000000000000000000000000000000011        
  111111000000000000000000000000000000000000000000000000000000000000000000000000000011         
   11111000000000000000000000000000000000000000000000000000000000000000000000000000011         
   1111100000000000000000000000000000000000000000000000000000000000000000000000000001          
    111110000000000000000000000000000000000000000000000000000000000000000000000000001          
     11111000000000000000000000000000000000000000000000000000000000000000000000000001          
      1111000000000000000000000000000000000000000000000000000000000000000000000000001          
       111100000000000000000000000000000000000000000000000000000000000000000000000001          
        11110000000000000000000000000000000000000000000000000000000000000000000000001          
         1111000000000000000000000000000000000000000000000000000000000000000000000001          
          111100000000000000000000000000000000000000000000000000000000000000000000001          
           11110000000000000000000000000000000000000000000000000000000000000000000001          
            1111000000000000000000000000000000000000000000000000000000000000000000001          
             111100000000000000000000000000000000000000000000000000000000000000000011          
              11110000000000000000000000000000000000000000000000000000000000000000011          
               1111000000000000000000000000000000000000000000000000000000000000000011          
                111100000000000000000000000000000000000000000000000000000000000000011          
                 11110000000000000000000000000000000000000000000000000000000000000011          
                  1111000000000000000000000000000000000000000000000000000000000000011          
                   111100000000000000000000000000000000000000000000000000000000000011          
                    11110000000000000000000000000000000000000000000000000000000000011          
                     1111000000000000000000000000000000000000000000000000000000000011          
                      111100000000000000000000000000000000000000000000000000000000011          
                       11110000000000000000000000000000000000000000000000000000000011          
                        1111000000000000000000000000000000000000000000000000000000011          
                         111100000000000000000000000000000000000000000000000000000001          
                          11110000000000000000000000000000000000000000000000000000011          
                           1111000000000000000000000000000000000000000000000000000011          
                            111100000000000000000000000000000000000000000000000000011          
                             11110000000000000000000000000000000000000000000000000011          
                              1111000000000000000000000000000000000000000000000000011          
                               111100000000000000000000000000000000000000000000000011          
                                111100000000000000000000000000000N0000000000000000011          
                                 1111000000000000000000000000000000000000000000000011          
                                  111100000000000000000000000000000000000000000000011          
                                   11110000000000000000000000000000000000000000000011          
                                    1111000000000000000000000000000000000000000000011          
                                     111100000000000000000000000000000000000000000011          
                                      11110000000000000000000000000000000000000000011          
                                       1111000000000000000000000000000000000000000011          
                                        111100000000000000000000000000000000000000011          
                                         11110000000000000000000000000000000000000011          
                                          1111000000000000000000000000000000000000011          
                                           111100000000000000000000000000000000000011          
                                            11110000000000000000000000000000000000011          
                                             1111000000000000000000000000000000000011          
                                              111100000000000000000000000000000000011          
                                               11110000000000000000000000000000000011          
                                                1111000000000000000000000000000000011          
                                                 111100000000000000000000000000000011          
                                                  11110000000000000000000000000000011          
                                                   1111000000000000000000000000000011          
                                                    111100000000000000000000000000011          
                                                     11110000000000000000000000000011          
                                                      1111000000000000000000000000011          
                                                       111100000000000000000000000011          
                                                        11110000000000000000000000011          
                                                         1111000000000000000000000011          
                                                          1111000000000000000000001111         
                                                           11110000000000000000011111          
                                                            111111000000000001111111           
                                                             11111111111111111111              
                                                               1111111111111111                
                                                                 11111111111                   
